 #####
 #   ####
 #      #
### **# #
#  #* *@#
#   * ###
#   #  #
##     #
 #.$#  #
 #  ####
 ####

       #####
     ###   #
    ##   # #
   ##     #
  ##     ###
 ##    ###
##  $. #
#  @ ###
#    #
######

   ####
   #  #
####  ###
#  @**  #
#  $**# #
## .**  #
## #   ##
#    ###
#   ##
#####

   ####
 ###  ##
## * * #
#  * * ##
#    *  #
#  $ * @#
###. ####
  #  #
  ####

   #####
 ###   ##
##   #  ##
#@ * * * #
#.  $ *  #
#### * ###
   #  ##
   ####

  ####
 ##  ###
##  .  #
# $.$.$##
# .$.$. #
##$ #.$ #
 #  @  ##
 #######

   #####
####   ##
#  * *  #
#  . *  #
##$.$*$##
 # . *@#
 #   ###
 #####

    ####
   ##  #
 ###   ####
## * * *  #
#  * * $  #
#  * # * ##
## . ##@ #
 #  ######
 ####

 ####
 #  ###
##    ####
#  * *   #
# $#*#*  #
## * *   #
 # @. * ##
 ###  ###
   ####

 ####
##  ####
#      ##
# **@** #
##  #   #
 # **$ ##
 #  *  #
 ## . ##
  ##  #
   ####

    ####
    #  ###
  ###    #
### ** * #
#  . *$@##
#  ***  #
##    ###
 ###  #
   ####

 #####
 #@. #
 #$.$#
 # * #
 # * #
 # * ##
## *  #
#  *  #
#    ##
##  ##
 ####

        #####
##### ###   #
#   ###   @ #
# * * # * .##
##     $* ##
 #  *## * #
 ##  ##  ##
  ########

  #######
 ##  #  #
 #      #
## # #  #
#  *** ##
#@#*  $#
#  *** #
### .  #
  ###  #
    ####

  ####
 ##  ##
 #@ $ #
## .* ###
# $$*.* #
# #.. # #
#   $   #
###  ####
  ####